21011012
12100121
11211211
10122101
11211211
12100121
21011012